B B B B B B B B B B B B B B B B B B B B B B B B B B B B B B B B B B B B B B B B B B B B B B B B B B B B B B B B B B B B B B B B B B B B B B B B B B B B B B B B B B B B B B B B B B B B B B B B B B B B
B G G g G G G g g g G G g G G G g g g G g g G g g g g g g G g G g G g G g G G g g G G G g g G G G g G g G g G g g G G G g G g g G G G G g g g G G G g G G g G G G G G G G g G g G G G G g G G g g G G B
B G G G G G g G G g g G G g g g G G G G g G G g g g g G G g g G G G G G g g G G G G G G g G g g G G G g g G G g G G G G G g G G G G g G G g G G G G G g g g G g g G G G G G g G g g g g G G G G g G g B
B G G g G g G G g G G G G G G g G G g g G g G G g g g g g g G G g G G G g G g G g g g g g G g G G g g g g G G g G G g G g G G G G G g g G G G G G g G G G g g g G g G G G G G G G g g G G G g g G G g B
B G G G g G G g G G g G G g l G G g G G G G G G g G G g g G G g G G G G G g G g G G G g g g G G g G G G g G G g G g G G g g G g G G G G G G g g G g G g G G G G g G g G G G G G G g G g g g g G g G g B
B G G G g N G G G g G g G l l l G G G G g G G G G g G G G G G g G G G g g g g G G G G g g G G G g G G G g G g G G G g g g G g G g G G g g G g G G g g G g G G G g G g g g g G G G g G g g G G G G G g B
B g g G G G G g G g G G l l l l l G G G G g G g g G G g G G g g G G g g g G G G g G G g g G G g g G G G g g G G G G G G g G g G G G G G G G g G G G g g g g G G g G G G g g g G g G G G g g G g G G g B
B g G G G g G g g g G g g l l l g g g g g g G G g G G G g G g G G g g g g G g G G G G g G G G G G g g G g G G g G g g G G G G G G G G G G G G g G G g g G G G g G g G g G G G G G G G g g G g G G g g B
B g g G G g g G G g G g g G L G g g G g G G G g G G g G G G G g g G G G G G G G G G g g g g g g G G G g G G G G G G g G G G G G g g G g g g g G g G g G G G G G G g g g g G g g G g G g g G g g G G G B
B g G G G G G g g G g g G G L g g G g G G G G G G G G g G G g g G G G g G G G G g G G g G G G g G g G G G g g g g G g G G G G g G g g G G G G G G G g g g G G g G G G G G G g G g g G G g G g G g g g B
B G g g G G G G G g G g G g g g G g g g g G G g G G G G G G G G G G g g G G G g G G g g g g G g G G g G G g g G g G g G g G G g g G g g g G g G g g G G G G G G g g G g G g g G G g G G G g G G G G g B
B g g G G g g g g G G g G g G G G G g g G g G G G g g G G G G g G G G g g G G G g g G g G G G g g g G G g g G g G G g G g G G g G g G g G G g G G G G G G G g g g g g g g G G G g G g G g G G g g G G B
B G G G g G g g G G G G G g G G g G G g G g g G g g G g g g G g g g G g G g g G G g g G g g G G g g G g g g g g g G G g G G G G G G g G G g G G g g g G g G G g G G g G g G G g G G g g g G g g g g g B
B G g G g g G G g G g g G g G g G G g G g g G G G g g G G G G G G g G G g G G g g G G g g g G g G G g G g G G g G G G G G G G G G G g G G g G g g G g G g g g G G G g g G G G g g g G g g g G G G g G B
B g g g g g g g G g G g g G G g g G G g G G g G g G g G G g G G g G G G g g g G g G g G g g G g G G G G g g G g G G G g G g g G g g g g G G G g g g G G G g G G G G G g g G G g G G G g G g g G G g G B
B G G g G G G g g G G g G G g G G G G g G G G G g G G g g g G G g g G G g g G g G g g G G G G G G g G G G g G G G g g G G G g G g g g g G G G G G g g G G G G G G G G g g G G g G G G g G g G g G G g B
B G G G g G G G g g g G G g G G G g G G G G G G G g G G G G G g g G G G g g g G g g T T T T T T T T T T T T g g G g g g G g G G g g g g G G g g g G G G g g G G G g G G g G g G G G G g G G G G G g G B
B G G g G G g G g g G g G G G g G g g G G g g G G G g g g G G G G g g G G g G g g G T T T T T T T T T T T T G G G g G g G g G G G G G g g G G G G G g g G g g g g G g g G G g g G G g g g G g G G g g B
B T T T T T T T T T T T T T T T T T G G g g G G G g g G g G G G G G G G g g G G G g T T T T T T T T T T T T g g G g G G G g g G G g G G G G G G G G g G G G G g g g g G g g G G G g g G G G G G G G G B
B T T T T T T T T T T T T T T T T T G G g G G G G g G G g g G G g g G G g G G g G G T T T T T T T T T T T T G g G G G g G G G G g g G g G G G g g G G G G g G G g g G g G g G G G G g G G g G g g g g B
B T T T T T T T T T T T T T T T T T g G G G G G G G G g g G g G g G G g g G G g G g T T T T T T T T T T T T G G G g G g G g g g G g G G G g G G G G g G G g g g g g G G G g G G G G G g g g G G G G g B
B T T T T T T T T T T T T T T T T T G G g G G G g g G G G g G G G G g G g G g G G G T T T T T T T T T T T T G G G g G G G G g G G G G g G G G G G G G g G G g G G g G G G G G G G g G g G G G G G G G B
B T T T T T T T T T T T T T T T T T G G g G G G G g g G G G G G G G g g G G G G G G T T T T T T T T T T T T G G G G G G g G g g G g G g G G G G g G G G G g G g G G G g G G g g g G g g g G g G G G G B
B T T T T T T T T T T T T T T T T T G G G G G G g g g g g g g G g g g g G G G G G g T T T T T T T T T T T T g G g G G g g G G g g G g g G G g g G G G G G G G G g g G g g G g g G g g G g G G G g G G B
B T T T T T T T T T T T T T T T T T G G G G g G G g g g g G g g g G g G g g g g G g T T T T T T T T T T T T g G G G g G G g g G G G g G g G G g g G G g G G g G g G g g G g g G G G G g G G G g G g G B
B G G T T T T T T T T T T T T T T T g g g g G G G G g g G G g G G G G G g g G g G g T T T T T T T T T T T T G g G g g G G g g g G g G G g G G G g G G G g g g G G G g G g G G G G G g g g G G g G g g B
B G g T T T T T T T T T T T T T T T g g G g g G G G g G g g G g g g g G G G G g G g T T T T T T T T T T T T g g G G g G g g g g g G G g g G g g G g g G G G g G G G G G g g g g G g g g G g G g G g G B
B G T T T T T T T T T T T T T T T T g G g G G g G G g g g G G G G g G G g g g G g G T T T T T T T T T T T T g G G g g G g G G G G G G G G G G G G G g G g g G g g g g g G g G G G G G G g G G g g G G B
B g G g g G G g g G g G G G G G G G g g G g g g g G g g g G G G G g g G g g g g G G T T T T T T T T T T T G g g g g G G G G G g G G g G G g G g G G G g G g G G g G g G G G g g g G G g g G g g G G g B
B G g G g G G G G G g G G G G g g g g g G G G g G g g G G G G G g G G g G G g G g T T T T T T T T T T T T G G g G g G G g G G g g G g g g G g g G G G G G G g G G G g g G g g G G G g G G g G G G g g B
B g G G g G g g g g G G G G G G g g G g g g g G G g G G G G G g g G G G G g g g g T T T T T T T T T T T T g G G g g g g g g G G G g G G g G g G g g G g G G G G g g G g G G g G G G G g G G G g g g g B
B G g T T T T T T T T T T T T T T T G g G G g G g G g G g G G G G G g G G G G g g T T T T T T T T T T T T G G G G g g G G g G G G g G g g G G g g g g G G g G g g G G G g g G g G G G g G G G G g G g B
B g g T T T T T T T T T T T T T T T G g g G g g G G G G g g g G g G G G g g G G g T T T T T T T T T T G g G g G g g G G G g G g g G g G G G g g g G G G G g G g G g G g G g G g G G g G g G g G G G G B
B T T T T T T T T T T T T T T T T T g G g g g G G G g G g g G G G G g G G g g G G G G G G G G G G G G G G G G g G G g G G g G g G G g G g G G g G g g G G G G G G G g g g G g g G g G G g G G G G g G B
B T T T T T T T T T T T T T T T T T g G G G g G G g g g G G G G G G g G g G G g G g g G g G g G G G G g G g g G G G g G g G G G g G G g G G G G G G g g G G G g G G g g G G G g G g g G G G G G G G g B
B T T T T T T T T T T T T T T T T T g G G G g G G G g g G g G G g g g g g G G g G g G G g G G g g G g G G G G g g G G g g G g G G G g G G G g G g G G G G G G G g G G G G G g g g G g G G G G G G G G B
B T T T T T T T T T T T T T T T T T G g G G G g G G g G G G G G G g G g g G G G G G g g g G g G g g G G G G g g G G G G G G g G G g g G G g g G g g G g G G g G G G g g g G G G g G G g g G G g G G G B
B T T T T T T T T T T T T T T T T T g g G G G G g G G G G g g G G G G G g G g g G G g g g G G G G G g G g G g g G G g G G G g G g g g G G g g G g G G G G g G G G g g G g G G G g G G g G G G g G G g B
B T T T T T T T T T T T T T T T T T g G G G G G G G G G g G G g G G G g G G g G g G G G G g G g G g G g g g G G g g G g G G g G G G g g g g g G g G G G G g g G g G G g G g g g G g g G g G G G G G G B
B T T T T T T T T T T T T T T T T T G G G g G G g g G g G G g G g g g g G G G G G G G G g G G g g G G G G g G g G G G g G G G G G G G g g G G g G G g G G G G G g G G g g G g G G G G g g g g g G G G B
B T T T T T T T T T T T T T T T T g G G G g G G G G g g G G G g G G G g g G G G G g G G G G G g g g G G G G g G G g G g G g g G G G G g G G g G G g g g G G G g G g g g g G g G g G g G G g G G G G G B
B T T T T T T T T T T T T T T T T G G g G g G G G G G g G G G G G G G G g G G g G G G G g g G g G G G g g G G g G G g g G g G G G g G G G g g g g g G g g G G G G G g G G G G G g g G g g g G G g g g B
B G g G g G G g G G g g G G G g g G G G G G G G G G G g G G g g G G G G G G g G g g g G G g G G g g G G G g g g g G G g G g G G G g G G g G G G G G G G G G G g G g G g G G g g g G g G G g g g g g G B
B G G g G G G G g g G G G g G g g g G g G g g g G G g G G g g g g g g g g G G G g g G G g g g G g g G G G G g g G G g G G G G G G G G G G g G G G G G g G g g G g g G g G g G g g G G G g g G g G g G B
B G g G G G G G G g g G g g G g g G g g G g G g g G g g g g G G G G G G g g G G G G g G G g g g g G G g G G G G G g g G G G G G G G g g G G g g G G G g G g g g G G G G g G G G G g g g G G g G G G G B
B G g g G g g G g g g g G G G G G G g g G g G g G g G g G G G g g G g G G G g g G g G G G G G G g g g g G G g G G G G G g G g G G g g G G g G g g G G g G g G G G G G G g G g G G g g g G G G G G G G B
B G G G g g g G g g G G g G G g G G g g g g g g G G G g g g g G g G g g G g G G g G G g g G G G g g G g g G G g G G G G G g g G G G G G g G G g G g G g g G G G G G G g g g G G g g G G G G G G g g g B
B T T T T T T T T T T T T T T T T T g G g g g G g G g g G G g G g g g g G G g G g G g G G G g G G G g G G g G G g G G G G g G g G G G g g G G g G g G G G G G G g g G g g g g G G g g G G G g G G G G B
B T T T T T T T T T T T T T T T T T G G g g g G G g G G G G G g G G G g g g g G g g G g g G g G g G G g g g G G g G G G g G g G G G g g g G g G G g G G G G g g g g G G g G g G G G g g g G g g g g G B
B T T T T T T T T T T T T T T T T T g G G G G G g G g g G G G G G g g G G g g G g G G G G g G G g G g g g G g G g G G G g G G g G G g g g G g g g G G g G G G G G G G G g g g g g g g g G G G G G G G B
B T T T T T T T T T T T T T T T T T G G G G G G g G G G G G g G G G G G G G g G g g G G G G G g G g G G G G G G g G G G g g G g G G G G G g G G G g G G G G G G G g g G G G G G G g g G g G G G g G G B
B g T T T T T T T T T T T T T T T T g G G g g G g G G G g G G G G g G G g G G G G G G G G G G G G G G G g G g g G G G g G G G g G G g G G g G g g g g G G g G G g G g g G G g g g G g g g g g g g G g B
B G T T T T T T T T T T T T T T T T G G g G g G G G g G G g G g G g G G g g g g G G G G G g g g g G G g G g G g G G g g G G G g g g g g G G g G G g g g G g G G G g G G g g g g G g G G G g g g G g G B
B g T T T T T T T T T T T T T T T T G G G G G g G G G G g g g g g G G g g G g g G g G G G g g g G G G G G g G G g G G g G G g g G G g G G g G G g g G g G G g G g G G g G g G g G G g G G g g G g g G B
B G T T T T T T T T T T T T T T T T g G G G g g G G G G G g G G g g g G G G g g G g G g G G g g G G G G G G g G g G G g g G g G g G G g G G G g G G G G g G G g g G G g g g g g g g G g G G G G G G G B
B G T T T T T T T T T T T T T T T T G g G G g G G g g G g g G g G G G G G G g G G g G G G g G G G g g g G G g g G g G g G g G g g G g G g g G g g G g G g G g g g g G g G G G G g G g g G G g g G G g B
B G G G G G g G g G G g G g g g G G g g G g G G G G G g G G g g G g G g g g G G G G g G G g G g G G g g g g g G G g G G G g G G g G G G G G g g G g G g G G G g g g G G g G g G g G G G g g G G G g g B
B G g g g G G g G g g g G g G g g g g G G g g g G G g g g g G G g G G g g G G g G G g G G G G G G g g G G g G g G G G G g g g G g g G G g g g G g g g G G G g G g g G g G G G g G G G G G g g G G G G B
B G G g G g G G G G g g G G G G G G G G G G G G G g g G g g G G G G G G G g G G G G G g G G G G g g G G G g g G g G g G G g g g G G G G G G g g g G G G G G G G g g g G G g g G G G G g G G g g G g G B
B g G G N g g G g g G G G G g G G g g G g g g g G g g g G g G G G G g g G G g G g g G G G g G G G g G G g g g G g g g G G G G g g G G G g g G g g g G g G G G G G g G G g G g G G G G g G g g G G G G B
B G G g G G G g G g g G G g g g G g g G G g g G g g g G G g G G G G g G g G G G G G g G g g G G g G G G g G g G g g g G g G g G g G G g g G G g g G g g G G g g G g G G G g G G g g g g G g G g G G g B
B G G G G g G G G g G g G G g G G G g G G g g G G g G G G G G G g g G G G G g G g G G G G g g g G G G G G G g g g g g g g g G G G g g G G G g G G g G G G g g g g G G G g G G G g G G g g G g G g g G B
B g G G g G g g G G G G g g G g g G G G G G g G g g g G g g G g G g G G G G G G G G g g g G G g g G G G G g G G g G g g g g G G g g G G G G g G G G g G g g G g G G G G G g G G g G G G g g G g G G g B
B g G g G G g G G G G G g g G g G g g g G G G g g G G g G g G g G G G G g G G G g g g g g g g G G G g G g G G g G g G G G G G g G G G G g G g g g G g g G G G g g G G g g g G G g G g G g G g G G g g B
B G G G g g g G G g G G G T T T T T G G g G g g g g G g g G G g G g G G G G g g G g g g G g G G G g g G G G G G g G G g g G G G G g G G g g G G G g G G g G g G G G G g g G g g g G G G G g G G g G g B
B g G g G g g G g T T T T T T T T T g G g G g g g g G G G G g G g g g g g G G g G g G g G G G G G G G g G G g g G g G g G G g g G G G G G g G G G G G g G G g g G G g G G G G G G g G G g G G g g G G B
B G T T T T T T T T T T T T T T T T G G g G g G G G G G g G g G g G g G G G g G g g G G G g g G G G G G g g G G g G G g g G g G G G G g g G g G G G g G G G g G G G g G g G G G g G g G G G g G g g g B
B g T T T T T T T T T T T T T T T T g G G G G G G G G g g g G G g G G G g g G G G g G G G G G G g g G G g G G G G G G g G G g g g G g G G G g g g G G G G G G G G G G g G g G g g G g G G g G g g g G B
B g T T T T T T T T T T T T T T T T g G G G g g G G G G g G G G g g g g G G G g G G g G g G G g G G G g G G g G G g g g G g G G g G G G G g g g g G G g G G g G G g g g G G G g g G g G G G G g G G G B
B g T T T T T T T T T T T T T T T T g G g G G g G g g G g G G G g g G G g G g G G G G G G g G g G G g G g g g g G G G g g g G G G G G G G g G G g g G g g G G G G G G g G G G G g g g G g g g G G G G B
B G T T T T T T T T T T T T T T T T g G g G G g G G g G g G g G G G g G G G G g g G G g G G G G G g G G G G g G G g g G g g G G G g g G G g g G G G G g G g G G G G G G G g G G G g g g G g G g g G G B
B g T T T T T T T T T T T T T T T T G G g G G G G G G G G g G G G G G G G g G g g g G G g G G G g g G g g g g G g g G G g G G G G G G G G g g g g g G G G G G G G G g g G G G G G G G g g G G g G G g B
B G g g g G G g g g g G g G g g g G G G G G G g g g G G G G G G G G g G G G G G G G G G g G G g g G G G G g g g G g g G g g g G G g G G G G G G g g g g G G G g g g G g g g g G g G G G g G G G G G G B
B G G g G G g G G g g G g G G G g g g G G G g g g g g G G G g G G g g g g g G g G G G G G g G g G G G G G g g G G G g G g G G g g g G g g g g g G G g g G g g g G G G g G G G g g G g g g g G g g g g B
B G g G g G G g G G g G G G G G G G G G G G G g G g g G g g G g g g g G G G g g G G G g g G G G G g g g G G G G G g g G G G G G G G g G G G g G G G G G g g G g g g G G g g G g G G g G g G G G G G G B
B G g G G g G G g g g G G G g G G g g G G G G g G g G g g G G G g G G G G g g g G G G G g g G G g G g g G G g G G g g G G g g g G G G g G G g g G g G g G g G G g G g G g G g G G g g G g g g g G G G B
B G G g g G G G g G G g G G G G G g l G G G G g G g G G G g G g G G G G G g g G g G g g G g G G G G g G g G G g G G G G g g g G G G G G g G G G g g g G G G g G G G G G g G G G G G g G G G g G g G G B
B G g G l G G G G G G G l g g G G l l l G G G g g g G G g G G g G g g G g G G G g G g G G g g G G g G G g g G G G G G g G G g G g g G g g G g g G G G g G g G g G g g g g G G G G g g G G G g G G G g B
B G G l l l G g g G G l l l g G G G L G g g G g G G G G G G g g g G G G G G g g g G g G G G G G g g G g g G g G g g G g g G G g G G g g G g g G G g G g G G G g g G G G G g G G g g g g G G g g g g g B
B G G G L g G G G g l l l l G G g g L g g g G G g G G G G g g G g G G G g g g G G G g g G G G g G g g G g G G G G g g g G G G g g G G G g G g G G g G g g g G G g G G g g G G G g g G G g g G G G g g B
B G G G L g g g g g g G L g g G g G G g G G G G G G g G g G g g G G G G G G G G G g G g g g G G G g g g G G G g G G g g G g G G G G g g G G G g g G G G g G g G g G g G G g G G G g G g G G G g G G G B
B g G g L G g G g G G G L g G g g g g G G G g g G g g g g g G G G G G g g g G G G g G G G G g G g G g G g g g g g G g G G G g G G G G g g G G g g g g G g g G G G G G G G g g g G G g G G G G G g g G B
B G g G g g G g g G g G G G g G g G G g g g l G G G g G g G G g g G g g G G g G G G g g G G G G G G G g G g G G G G G G G g g g G G G G G G G g G g G g G G G G G G G g G g g G g G G G G G G G G g g B
B g G G G G g g g g G g G G G G g g g G G l l l G G G G G G G G G G G g G g g G G G G G g g G g G G G G G g g G G g G G G G g G G g g g G g G G G G g g G g G G g g g g G G G g G G G g g G G G G g g B
B G g g G G G G G g g G G g g G G G G g l l l l l G G g G g G G g g G g G G g G g g g G g g g g G g G G G g G G G G G G G g g G g g g g G g G g g g g G g G G g G G G g G g G G G g G G g G G g G G G B
B g g G g G g G g G G g G G G G G G G G G l l l G G g G G G G g g g G G G G g G g g g G g g G G G G G G G g G G g g G g G g g G G g G G g g G G G g G G G g G G g G g G G g g G G G G G g g G g G G G B
B G G g G G G G G g G G g g G G G g g G g G L g g G G G G g g G g G G g G G G G G g g G G G G g G G G G g G G g G g G G G g G G G G g g G G g G G G G g G G G G g G g G g g G G G g G G g G g g g G G B
B g g G G g G G G G G G g g G g g g g g g G L g g G G g g g G G G g g g G G G g g G G g g g G G g G G g G g G G G g g g G G G G g g g G g G g g G g G G g g G G g G g g g G g g G G G g g g G G g G g B
B G g G G G G g g G G G G g G g G G g G g g g G G G g G G G g G g g T T T T T T T T T T T T T T T T T T T T T T T T T T T T T T T T T T T T G g g G g g G G N G G G g G g g g g g G G g G G G G g G g B
B g g g G g g G G g g G g G G G G g g g G g g G G g g G G G G g G T T T T T T T T T T T T T T T T T T T T T T T T T T T T T T T T T T T T T G G g G g G g G g g G g G G G G G G G g g g G G g l G G g B
B g G G g G G G G g G G G g g G G G G g G g G g g G g g g G g G G T T T T T T T T T T T T T T T T T T T T T T T T T T T T T T T T T T T T T g G G G g G g G G G g g G G G G g G G g G g G G l l l G G B
B g G G g G G G g g g g g G g G G g g g G G G G g G G G g g g T T T T T T T T T T T T T T T T T T T T N T T T T T T T T T T T T T T T T T T G g G G G g G G g G g g G g G g G g G g G G G l l l l l g B
B g G G G G g G G G G G G g G g G G g G G g G G G G G g G G G T T T T T T T T T T T T T T T T T T T T T T T T T T T T T T T T T T T T T T T g G g G g G G G G G G g g G G g g G g G G g G G G L g g g B
B G G G G g G G g G g G G g G g G G g G G g l G G G G G G G G T T T T T T T T T T T T T T T T T T T T T T T T T T T T T T T T T T T T T T T G g G g G G G G g G G G G G G g g G G G G G G G G L g g g B
B g G G G g G G g G G g g G g G g g G G g l l l G g G G G G G T T T T T T T T T T T T T T T T T T T T T T T T T T T T T T T T T T T T T T T g G G G N G g g G g g G g g N G g G g g G g G G g L G g G B
B G G G G G G G G G G g G G g G g G G g g g L G g g g G g g G G G G G G g G g G g g g G G g g G g g g g G g G G g G g g G G G G G G G G g g G g G g G G g g G G G G G G g G g G G G G g g g G G g G g B
B G G g G G G G G g G G G G G g G G G g G g L G g G g G g G g G G G g G g G G G G g G g g G g G g g G g g g G G g g G g g G g G G G G g G G G g g g g G G G G g G G G G G G G G G G G G G G G g g G G B
B G g g G g g g g G G g G g g G G G G G G g G G g g g g G G G g G G g G G G G G G g g G G G G g g g G G g G G G G g g g G G G G g G g G G G g G G G G g G G g G G g g G G g g g G G g G g g G G G g G B
B G g G g G g G G G G G g G g G g G G G G g G g G G g G g G G G G g G g G G g G G g g G G G g G G G G G G g G G g G g g g G g G g G g G G G g G G G G G G G G G G G g G g g G G G g G g g g G g g g g B
B B B B B B B B B B B B B B B B B B B B B B B B B B B B B B B B B B B B B B B B B B B B B B B B B B B B B B B B B B B B B B B B B B B B B B B B B B B B B B B B B B B B B B B B B B B B B B B B B B B B