B B B B B B B B B B B B B B B B B B B B B B B B B B B B B B B B B B B B B B B B B B B B B B B B B B B B B B B B B B B B B B B B B B B B B B B B B B B B B B B B B B B B B B B B B B B B B B B B B B B B
B G G g G G G g g g G G g G G G g g W G g g G g g g g g g G g G g G g G g G G g g G G G g g G G G g G g G g G g g G G G g G g g G G G G g g g G G G g l G g G G G G G G G g G g G G G G g G G g g G G B
B G G G G G g G G g g G G g g g G G W G g G G g g g g G G g g G G G G G g g G G G G G G g G g g G G G g g G G g G G G G G g G G G G g G G g G G G G l l l g G g g T T T T G g G g g g g G G G G g G g B
B G G g G g G G g G G G G G G g G G W g G g G G g g g g g g G G g G G G g G g G g g g g g G g G G g g g g G G g G G g G g G G G G G g g G G G G G g G L G g g g G T T T T G G G G g g G G G g g G G g B
B G G G g G G g G G g G G g l G G g W G G G G G g G G g g G G g G G G G G g G g G G G g g g G G g G G G g G G g G g G G g g G g G G G G G G g g G g G L G G G G g G g G G G G G G g G g g g g G g G g B
B G G G g N G G G g G g G l l l G G W G g G G G G g G G G G G g G G G g g g g G G G G g g G G G g G G G g G g G G G g g g G g G g G G g g G g G G g g G g G G G g G g g g g G G G g G g g G G G G G g B
B g g G G G G g G g G G l l l l l G W G G g G g g G G g G G g g G G g g g G G G g G G g g G G g g G G G g g G G G G G G g G g G G G G G G G g G G G g g g g G G g G G G g g g G g G G G g g G g G G g B
B g G G G g G g g g G g g l l l g g W g g g G G g G G G g G g G G g g g g G g G G G G g G G G G G g g G g G G g G g g G G G G G G G G G G G G g G G g g G G G g G g G g G G G G G G G g g G g G G g g B
B g g G G g g G G g G g g G L G g g W g G G G g G G g G G G G g g G G G G G G G G G g g g g g g G G G g G G G G G G g G G G G G g g G g g g g G g G g G G G G G G g g g g G g g G g G g g G g g G G G B
B g G G G G G g g G g g G G L g g G W G G G G G G G G g G G g g G G G g G G G G g G G g G G G g G g G G G g g g g G g G G G G g G g g G G G G G G G g g g G G g G G G G G G g G g g G G g G g G g g g B
B G g g G G G G G g G g G g g g G g W g g G G g G G G G G G G G G G g g G G G g G G g g g g G g G G g G G g g G g G g G g G G g g G g g g G g G g g G G G G G G g g G g G g g G G g G G G g G G G G g B
B g g G G g g g g G G g G g G G G G W g G g G G G g W W W G G g G G G g g G G G g g G g G G G g g g G G g g G g G G g G g G G g G g G g G G g G G G G G G G g g g g g g g G G G g G g G g G G g g G G B
B G G G g G g g G G G G G g G G g G W g G g g G W W W W W W G g g g G g G g g G G g g G g g G G g g G g g g g g g G G g G G G G G G g G G g G G g g g G g G G g G G g G g G G g G G g g g G g g g g g B
B G g G g g G G g G g g G g G g G G W G g g G G W W W W W G G G G g G G g G G g g G G g g g G g G G g G g G G g G G G G G G G G G G g G G g G g g G g G g g g G G G g g G G G g g g G g g g G G G g G B
B g g g g g g g G g G g g G G g g G W g G G g W W W g G G g G G g G G G g g g G g G g G g g G g G G G G g g G g G G G g G g g G g g g g G G G g g g G G G g G G G G G g g G G g G G G g G g g G G g G B
B G G g G G G g g G G g G G g G G G W g G G G G g G G g g g G G g g G G g g G g G g g G G G G G G g G G G g G G G g g G G G g G g g g g G G G G G g g G G G G G G G G g g G G g G G G g G g G g G G g B
B G G G g G G G g g g G G g G G G g W G G G G G G g G G G G G g g G G G g g g G g g T T T T T T T T T T T T g g G g g g G g G G g g g g G G g g g G G G g g G G G g G G g G g G G G G g G G G G G g G B
B G G g G G g G g g G g G G G g G g W G G g g G G G g g g G G G G g g G G g G g g G T T T T T T T T T T T T G G G g G g G g G G G G G g g G G G G G g g G g g g g G g g G G g g G G g g g G g G G g g B
B T T T T T T T T T T T T T T T T T W G g g G G G g g G g G G G G G G G g g G G G g T T T T T T T T T T T T g g G g G G G g g G G g G G G G G G G G g G G G G g g g g G g g G G G g g G G G G G G G G B
B T T T T T T T T T T T T T T T T T W G g G G G G g G G g g G G g g G G g G G g G G T T T T T T T T T T T T G g G G G g G G G G g g G g G G G g g G G G G g G G g g G g G g G G G G g G G g G g g g g B
B T T T T T T T T T T T T T T T T T W G G G G G G G G g g G g G g G G g g G G g G g T T T T T T T T T T T T G G G g G g G g g g G g G G G g G G G G g G G g g g g g G G G g G G G G G g g g G G G G g B
B T T T T T T T T T T T T T T T T T W G g G G G g g G G G g G G G G g G g G g G G G T T T T T T T T T T T T G G G g G G G G g G G G G g G G G G G G G g G G g G G g G G G G G G G g G g G G G G G G G B
B T T T T T T T T T T T T T T T T T W G g G G G G g g G G G G G G G g g G G G G G G T T T T T T T T T T T T G G G G G G g G g g G g G g G G G G g G G G G g G g G G G g G G g g g G g g g G g G G G G B
B T T T T T T T T T T T T T T T T T W G G G G G g W W W W W g G g g g g G G G G G g T T T T T T T T T T T T g G g G G g g G G g g G g g G G g g G G G G G G G G g g G g g G g g G g g G g G G G g G G B
B T T T T T T T T T T T T T T T T T W G G G g G G W W W W W g g g G g G g g g g G g T T T T T T T T T T T T g G G G g G G g g G G G g G g G G g g G G g G G g G g G g g G g g G G G G g G G G g G g G B
B T T T T T T T T T T T T T T T T T W g g g G G G W W W W W g G G G G G g g G g G g T T T T T T T T T T T T G g G g g G G g g g G g G G g G G G g G G G g g g G G G g G g G G G G G g g g G G g G g g B
B T T T T T T T T T T T T T T T T T W g G g g G G W W W g g G g g g g G G G G g G g T T T T T T T T T T T T g g G G g G g g g g g G G g g G g g G g g G G G g G G G G G g g g g G g g g G g G g G g G B
B B T T T T T T T T T T T T T T T T W G g G G g G G g g g G G G G g G G g g g G g G T T T T T T T T T T T T g G G g g G g G G G G G G G G G G G G G g G g g G g g g g g G g G G G G G G g G G g g G G B
B B B B g G G g g G g G G G G G G G W g G g g g g G g g g G G G G g g G g g g g G G T T T T T T T T T T T G g g g g G G G G G g G G g G G g G g G G G g G g G G g G g G G G g g g G G g g G g g G G g B
B B B N g G G G G G g G G G G g g g W g G G G g G g g G G G G G g G G g G G g G g T T T T T T T T T T T T G G g G g G G g G G g g G g g g G g g G G G G G G g G G G g g G g g G G G g G G g G G G g g B
B B B B g G g g g g G G G G G G g g W g g g g G G g G G G G G g g G G G G g g g g T T T T T T T T T T T T g G G g g g g g g G G G g G G g G g G g g G g G G G G g g G g G G g G G G G g G G G g g g g B
B B g T T T T T T T T T T T T T T T W g G G g G g G g G g G G G G G g G G G G g g T T T T T T T T T T T T G G G G g g G G g G G G g G g g G G g g g g G G g G g g G G G g g G g G G G g G G G G g G g B
B g g T T T T T T T T T T T T T T T W g g G g g G G G G g g g G g G G G g g G G g T T T T T T T T T T G g G g G g g G G G g G g g G g G G G g g g G G G G g G g G g G g G g G g G G g G g G g G G G G B
B T T T T T T T T T T T T T T T T T W G g g g G G G g G g g G G G G g G G g g G G G G G G G G G G G G G G G G g G G g G G g G g G G g G g G G g G g g G G G G G G G g g g G g g G g G G g G G G G g G B
B T T T T T T T T T T T T T T T T T W G G G g G G g g g G G G G G G g G g G G g G g g G g G g G G G G g G g g G G G g G g G G G g G G g G G G G G G g g G G G g G G g g G G G g G g g G G G G G G G g B
B T T T T T T T T T T T T T T T T T W G G G g G G G g g G g G G g g g g g G G g G g G G g G G g g G g G G G G g g G G g g G g G G G g G T T T T T T G G G G G G g G G G G G g g g G g G G G G G G G G B
B T T T T T T T T T T T T T T T T T W g G G G g G l g G G G G G G g G g g G G G G G g g g G g G g g G G G G g g G G G G G G g G G g g T T T T T T T G g G G g G G G g g g G G G g G G g g G G g G G G B
B T T T T T T T T T T T T T T T T T W g G G G G l l l G G g g G G G G G g G g g G G g g g G G G G G g G g G g g G G g G G G g G g g g T T T T T T T G G G g G G G g g G g G G G g G G g G G G g G G g B
B T T T T T T T T T T T T T T T T T W G G G G G G L G G g G G g G G G g G G g G g G G G G g G g G g G g g g G G g g G g G G g G G G g g g g g G g G G G G g g G g G G g G g g g G g g G g G G G G G G B
B T T T T T T T T T T T T T T T T T W G G g G G g L G g G G g G g g g g G G G G G G G G g G G g g G G G G g G g G G G g G G G G G G G g g G G g G G g G G G G G g G G g g G g G G G G g g g g g G G G B
B T T T T T T T T T T T T T T T T W W G G g G G G G g g G G G g G G G g g G G G G g G G G G G g g g G G G G g G G g G g G g g G G G G g G G g G G g g g G G G g G g g g g G g G g G g G G g G G G G G B
B T T T T T T T T T T T T T T T T W W g G g G G G G G g G G G G G G G G g G G g G G G G g g G g G G G g g G G g G G g g G g G G G g G G G g g g g g G g g G G G G G g G G G G G g g G g g g G G g g g B
B G g G g G G g G G g g G G G g g W W G G G G G G G G g G G g g G G G G G G g G g g g G G g G G g g G G G g g g g G G g G g G G G g G G g G G G G G G G G G G g G g G g G G g g g G g G G g g g g g G B
B G G g G G G G g g G G G g G g W W W g G g g g G G g G G g g g g g g g g G G G g g G G g g g G g g G G G G g g G G g G G G G G G G G G G g G G G G G g G g g G g g G g G g G g g G G G g g G g G g G B
B G g G G G G G G g g G g g G g W W W g G g G g g G g g g g G G G G G G g g G G G G g G G g g g g G G g G G G G G g g G G G G G G G g g G G g g G G G g G g g g G G G G g G G G G g g g G G g G G G G B
B G g g G g g G g g g g G G G G G W W g G g G g G g G g G G G g g G g G G G g g G g G G G G G G g g g g G G g G G G G G g G g G G g g G G g G g g G G g G g G G G G G G g G g G G g g g G G G G G G G B
B G G G g g g G g g G G g G G g G G W g g g g g G G G g g g g G g G g g G g G G g G G g g G G G g g G g g G G g G G G G G g g G G G G G g G G g G W W W W W W W W W W W W W W W W W B G G g B W W W W B
B T T T T T T T T T T T T T T T T T W G g g g G g G g g G G g G g g g g G G g G g G g G G G g G G G g G G g G G g G G G G g G g G G G g g G G g G W G G G B B B B B G G g g g g G G B g G G B g G G G B
B T T T T T T T T T T T T T T T T T W G g g g G G g G G G G G g G G G g g g g G g g G g g G g G g G G g g g G G g G G G g G g G G G g g g G g G G W G G G G B N B g G G g l l l G G g g g G g g g g G B
B T T T T T T T T T T T T T T T T T W G G G G G g G g g G G G G G g g G G g g G g G G G G g G G g G g g g G T T T T T g G G g G G g g g G g g g W G g G G W G W G G G g l l l g g g g g G g G G G G g B
B T T T T T T T T T T T T T T T T T W G G G G G g G G G G G g G G W W G G G g G g g G G G G G g G g G G G G G T T T G G g g G g G G G G G g G G G W G G G G W G W g g G G l l l G g g G g G G G g G G B
B g T T T T T T T T T T T T T T T T W G G g g G g G G G g G G G G W W W g G G G G G G G G G G G G G G G g G g g G G G g G G G g G G g G G g G g g W g G G g W G W G g g G G L g g G g g g g g g g G g B
B G T T T T T T T T T T T T T T T T W G g G g G G G g G G g G g G W W W g g g g G G G G G g g g g G G g G g G g G G g g G G G g g g g g G G g G G W g g G g W G W g G G g g L g G g G G G g g g G g G B
B g T T T T T T T T T T T T T T T T W G G G G g G G G G g g g g g G W W W G g g G g G G G g g g G G G G G g G G g G G g G G g g G G g G G g G G g W G g G G W G W G G g G g G g G G g G G g g G g g G B
B G T T T T T T T T T T T T T T T T W G G G g g G G G G G g G G g g g W W W g g G g G g G G g g G G G G G G g G g G G g g G g G g G G g G G G g G W G G g G W g W G G g g l g g g g G g G G G G G G G B
B G T T T T T T T T T T T T T T T T W g G G g G G g g G g g G g G G G G G G g G G g G G G g G G G g g g G G g g G g G g G g G g g G g G g g G g g W g G g G W g W g G g l l l G g G g g G G g g G G g B
B G G G G G g G g G G g G g g g G G W g G g G G G G G g G G g g G g G g g g G G G G g G G g G g G G g g g g g G G g G G G g G G g G G G G G g g G W G g G G W g W g G G g L g G g G G G g g G G G g g B
B G g g g G G g G g g g G g G g g g W G G g g g G G g g g g G G g G G g g G G g G G g G G G G G G g g G G g G g G G G G g g g G g g G G g g g G g W g G G G W G W g G g G L G g G G G G G g g G G G G B
B G G g G g G G G G g g G G G G G G W G G G G G G g g G g g G G G G G G G g G G G G G g G G G G g g G G G g g G g G g G G g g g G G G G G G g g g W G G G G W G W g g G G g g G G G G g G G g g G g G B
B g G G G g g G g g G G G G g G G g W G g g g g G g g g G g G G G G g g G G g G g g G G G g G G G g G G g g g G g g g G G G G g g G G G g g G g g W G g G G W G W g G G g G g G G G G g G g g G G G G B
B G G g G G G g G g g G G g g g G g W G G g g G g g g G G g G G G G g G g G G G G G g G g g G G g G G G g G g G g g g G g G g G g G G g g G G g g W g g G G W g W g G G G g G G g g g g G g G g G G g B
B G G G G g G G G g G g G G g G G G W G G g g G G g G G G G G G g g G T T T T T g G G G G g g g G G G G G G g g g g g g g g G G G g g G G G g G G W G G G g W g W G G G g G G G g G G g g G g G g g G B
B g G G g G g g G G G G g g G g g G W G G G g G g g g G g g G g G g G T T T T T T T g g g G G g g G G G G g G G g G g g g g G G g g G G G G g G G W g G g g G g G G G G G g G G g G G G g g G g G G g B
B g G g G G g G G G G G g g G g G g W g G G G g g G G g G g G g G G G T T T T T T T g g g g g G G G g G g G G g G g G G G G G g G G G G g G g g g W g g G G G g g G G g T T T G g G g G g G g G G g g B
B G G G g g g G G g G G G T T T T T W G g G g g g g G g g G G g G g G G G G g g G g g g G g G G G g g G G G G G g G G g g G G G G g G G g g G G G W G G g G g G G G G g T T T g g G G G G g G G g G g B
B g G g G g g G g T T T T T T T T T W G g G g g g g G G G G g G g g g g g G G g G g G g G G G G G G G g G G g g G g G g G G g g G G G G G g G G G W G g G G g g G G g G T T T G G g G G g G l g g G G B
B G T T T T T T T T T T T T T T T T W G g G g G G G G G g G g G g G g G G G g G g g G G G g g G G G G G g g G G g G G g g G g G G G G g g G g G G W g G G G g G G G g G T T T T g G g G G l l l g g g B
B g T T T T T T T T T T T T T T T T W G G G G G G G G g g g G G g G G G g g G G G g G G G G G G g g G G g G G G G G G g G G g g g G g G G G g g g W G G G G G G G G G g T T T T g G g G l l l l l g G B
B g T T T T T T T T T T T T T T T T W G G G g g G G G G g G G G g g g g G G G g G G g G g G G g G G G g G G g G G g g g G g G G g G G G G g g g g W G g G G g G G g g g T T T T g G g G G G L g G G G B
B g T T T T T T T T T T T T T T T T W G g G G g G g g G g G G G g g G G g G g G G G G G G g G g G G g G g g g g G G G g g g G G G G G G G g G G g W G g g G G G G G G g T T T T g g g G g g L G G G G B
B G T T T T T T T T T T T T T T T T W G g G G g G G g G g G g G G G g G G G G g g G G g G G G G G g G G G G g G G g g G g g G G G g g G G g g G G W G g G g G G G G G G G g G G G g g g G g G g g G G B
B g T T T T T T T T T T T T T T T T W W g G G G G G G G G g G G G G G G G g G g g g G G g G G G g g G g g g g G g g G G g G G G G G G G G g g g g W G G G G G G G G g g G G G G G G G g g G G g G G g B
B G g g g G G g g g g G g G g g g G W W G G G g g g G G G G G G G G g G G G G G G G G G g G G g g G G G G g g g G g g G g g g G G g G G G G G G g W g g G G G g g g G g g g g G g G G G g G G G G G G B
B G G g G G g G G g g G g G G G g g g W W G g g g g g G G G g G G g g g g g G g G G G G G g G g G G G G G g g G G G g G g G G g g g G g g g g g G W g g G g g g G G G g G G G g g G g g g g G g g g g B
B G g G g G G g G G g G G G G G G G g G W W G g G g g G g g G g g g g G G G g g G G G g g G G G G g g g G G G G G g g G G G G G G G g G G G g G G W G G g g G g g g G G g g G g G G g G g G G G G G G B
B G g G G g G G g g g G G G g G G g G G G W G g G g G g g G G G g G G G G g g g G G G G g g G G g G g g G G g G G g g G G g g g G G G g G G g g G W G g G g G G g G g G g G g G G g g G g g g g G G G B
B G G g g G G G g G G g G G G G G g l G G W G g G g G G G g G g G G G G G g g G g G g g G g G G G G g G g G G g G G G G g g g G G G G G g G G G g W g G G G g G G G G G g G G G G G g G G G g G g G G B
B G g G l G G G G G G G l g g G G l l l G W G g g g G G g G G g G g g G g G G G g G g G G g g G G g G G g g G G G G G g G G g G g g G g g G g g G W G g G g G g G g g g g G G G G g g G G G g G G G g B
B G G l l l G g g G G l l l g G G G L G g W G g G G G G G G g g g G G G G G g g g G g G G G G G g g G g g G g G g g G g g G G g G G g g G g g G G W G g G G G g g G G G G g G G g g g g G G g g g g g B
B G G G L g G G G g l l l l l G g g L g g W G G g G G G G g g G g G G G g g g G G G g g G G G g G g g G g G G G G g g g G G G g g G G G g G g G G W G g g g G G g G G g g G G G g g G G g g G G G g g B
B G G G L g g g g g g G L g g G g G G g G W G G G G g G g G g g G G G G G G G G G g G g g g G G G g g g G G G g G G g g G g G G G G g g G G G g g W G G g G g G g G g G G g G G T T T g G G G g G G G B
B g G g L G g G g G G G L g G g g g g G G W g g G g g g g g G G G G G g g g G G G g G G G G g G g G g G g g g g g G g G G G g G G G G g g G G g g W T T T g G G G G G G G g g g T T T T T T T G g g G B
B G g G g g G g g G g G G G g B B G B B g W G G G g G g G G g g G g g G G g W W W W g G G G G G G G g G g G G G G G G G g g g G G G G G G G g G g W T T T G G G G G g G g g G g T T T T T T T G g g g B
B g G G G G g g g g G g G G G B G g g B G W W G G G G G G G G G G G G g G W W W W W W g g g G g G G G G G g g G G g G G G G g G G g g g G g G G G W T T G g G G g g g g G G G g G G G g g G G G G g g B
B G g g G G G G G g g l G g g B G N G B g W W W g g G G g G g G G g g G g G W W W W g g G g g g g G g G G G g G G G G G G G g g G g g g g G g G g W T T G g G G g G G G g G g G G G g G G g G G g G G B
B g g G g G g G g G l l l G G B G G G B G W W W W g G G G G g g g G G G G g G g g g G g g G G G G G G G g G G g g G g G g g G G g G G g g G G G g W T T g G G g G g G G g g G G G G G g g G g G G G g B
B G G g G G G G G g G L g g G B B B B B g G g g W W G G g g G g G G g G G G G G g g G G G G g G G G G g G G g G g G G G g G G G G g g G G g G G G W g G G G G g G g G g g G G G g G G g G g g g G G G B
B g g G G g G G G G G L g g G g g g g g g G G g g W W W W W W W W W W W W W W W W W W W W W W W W W W W W W W W W W W W W W W W W W W W W W W W W W g G g g G g G G G g G G G G G G g g g G G g G g G B
B G g G G G G g g G G G G g G g G G g G g g g G G G g G G G g G g g T T T T T T T T T T T T T T T T T T T T T T T T T T T T T T T T T T T T G g g G g g G G g G G G g G g g g g g G G g G G G G g G g B
B g g g G g g G G g g G g G G G G g g g G g g G G g g G G G G g G T T T T T T T T T T T T T T T T T T T T T T T T T T T T T T T T T T T T T G G g G g G g G g g G g G G G G G G G g g g G G g l G G g B
B g G G g G G G G g G G G g g G G G G g G g G g g G g g g G g G G T T T T T T T T T T T T T T T T T T T T T T T T T T T T T T T T T T T T T g G G G g G g G G G g g G G G G g G G g G g G G l l l G G B
B g G G g G G G g g g g g G g G G g g g G G G G g G G G g g g T T T T T T T T T T T T T T T T T T T T T T T T T T T T T T T T T T T T T T T G g G G G g G G g G g g G g G g G g G g G G G l l l l l g B
B g G G G G g G G G G G G g G g G G g G G g G G G G G g G G G T T T T T T T T T T T T T T T T T T T T T T T T T T T T T T T T T T T T T T T g G g G g G G G G G G g g G G g g G g G G g G G G L g g g B
B G G G G g G G g G g G G g G g G G g G G g l G G G G G G G G T T T T T T T T T T T T T T T T T T T T T T T T T T T T T T T T T T T T T T T G g G g G G G G g G G G G G G g g G G G G G G G G L g g g B
B g G G G g G G g G G g g G g G g g G G g l l l G g G G G G G T T T T T T T T T T T T T T T T T T T T T T T T T T T T T T T T T T T T T T T g G G G G G g g G g g G g g G G g G g g G g G G g L G g G B
B G G G G G G G G G G g G G g G g G G g g g L G g g g G g g G G G G G G g G g G g g g G G g g G g g g g G g G G g G g g G G G G G G G G g g G g G g G G g g G G G G G G g G g G G G G g g g G G g G g B
B G G g G G G G G g G G G G G g G G G g G g L G g G g G g G g G G G g G g G G G G g G g g G g G g g G g g g G G g g G g g G g G G G G g G G G g g g g G G G G g G G G G G G G G G G G G G G G g g G G B
B G g g G g g g g G G g G g g G G G G G G g G G g g g g G G G g G G g G G G G G G g g G G G G g g g G G g G G G G g g g G G G G g G g G G G g G G G G g G G g G G g g G G g g g G G g G g g G G G g G B
B G g G g G g G G G G G g G g G g G G G G g G g G G g G g G G G G g G g G G g G G g g G G G g G G G G G G g G G g G g g g G g G g G g G G G g G G G G G G G G G G G g G g g G G G g G g g g G g g g g B
B B B B B B B B B B B B B B B B B B B B B B B B B B B B B B B B B B B B B B B B B B B B B B B B B B B B B B B B B B B B B B B B B B B B B B B B B B B B B B B B B B B B B B B B B B B B B B B B B B B B