B B B B B B B B B B B B B B B B B B B B B B B B B B B B B B B B B B B B B B B B B B B B B B B B B B B B B B B B B B B B B B B B B B B B B B B B B B B B B B B B B B B B B B B B B B B B B B B B B B B B
B G G g G G G g g g G G g G G G g g g G g g G g g g g g g G g G g G g G g G G g g G G G g g G G G g G g G g G g g G G G g G g g G G G G g g g G G G g G G g G G G G G G G g G g G G G G g G G g g G G B
B G G G G G g G G g g G G g g g G G G G g G G g g g g G G g g G G G G G g g G G G G G G g G g g G G G g g G G g G G G G G g G G G G g G G g G G G G G g g g G g g G G G G G g G g g g g G G G G g G g B
B G G g G g G G g G G G G G G g G G g g G g G G g g g g g g G G g G G G g G g G g g g g g G g G G g g g g G G g G G g G g G G G G G g g G G G G G g G G G g g g G g G G G G G G G g g G G G g g G G g B
B G G G g G G g G G g G G g G G G g G G G G G G g G G g g G G g G G G G G g G g G G G g g g G G g G G G g G G g G g G G g g G g G G G G G G g g G g G g G G G G g G g G G G G G G g G g g g g G g G g B
B G G G g N G G G g G g G G G G G G G G g G G G G g G G G G G g G G G g g g g G G G G g g G G G g G G G g G g G G G g g g G g G g G G g g G g G G g g G g G G G g G g g g g G G G g G g g G G G G G g B
B g g G G G G g G g G G g g G G g G G G G g G g g G G g G G g g G G g g g G G G g G G g g G G g g G G G g g G G G G G G g G g G G G G G G G g G G G g g g g G G g G G G g g g G g G G G g g G g G G g B
B g G G G g G g g g l g g g g G g g g g g g G G g G G G g G g G G g g g g G g G G G G g G G G G G g g G g G G g G g g G G G G G G G G G G G G g G G g g G G G g G g G g G G G G G G G g g G g G G g g B
B g g G G g g G G l l l g G G G g g G g G G G g G G g G G G G g g G G G G G G G G G g g g g g g G G G g G G G G G G g G G G G G g g G g g g g G g G g G G G G G G g g g g G g g G g G g g G g g G G G B
B g G G G G G g l l l l L L L g g G g G G G G G G G G g G G g g G G G g G G G G g G G g G G G g G g G G G g g g g G g G G G G g G g g G G G G G G G g g g G G g G G G G G G g G g g G G g G g G g g g B
B G g g G G G G G l l l G g g g G g g g g G G g G G G G G G G G G G g g G G G g G G g g g g G g G G g G G g g G g G g G g G G g g G g g g G g G g g G G G G G G g g G g G g g G G g G G G g G G G G g B
B g g G G g g g g G l g G g G G G G g g G g G G G g g G G G G g G G G g g G G G g g G g G G G g g g G G g g G g G G g G g G G g G g G g G G g G G G G G G G g g g g g g g G G G g G g G g G G g g G G B
B G G G g G g g G G G G l g G G g G G g G g g G g g G g g g G g g g G g G g g G G g g G g g G G g g G g g g g g g G G g G G G G G G g G G g G G g g g G g G G g G G g G g G G g G G g g g G g g g g g B
B G g G g g G G g G g l l g G g G G g G g g G G G g g G G G G G G g G G g G G g g G G g g g G g G G g G g G G g G G G G G G G G G G g G G g G g g G g G g g g G G G g g G G G g g g G g g g G G G g G B
B g g g g g g g G g l l l L L g g G G g G G g G g G g G G g G G g G G G g g g G g G g G g g G g G G G G g g G g G G G g G g g G g g g g G G G g g g G G G g G G G G G g g G G g G G G g G g g G G g G B
B G G g G G G g g G G l l G g G G G G g G G G G g G G g g g G G g g G G g g G g G g g G G G G G G g G G G g G G G g g G G G g G g g g g G G G G G g g G G G G G G G G g g G G g G G G g G g G g G G g B
B G G G g G G G g g g G l g G G G g G G G G G G G g G G G G G g g G G G g g g G g g G g G G g g g G G g G g g g G g g g G g G G g g g g G G g g g G G G g g G G G g G G g G g G G G G g G G G G G g G B
B G G g G G g G g g G g G G G g G g g G G g g G G G g g g G G G G g g G G g G g g G G g G G g g G g G G G g G G G g G g G g G G G G G g g G G G G G g g G g g g g G g g G G g g G G g g g G g G G g g B
B G G g G g g g G g G G G g G G G g G G g g G G G g g G g G G G G G G G g g G G G g G G g G g g G G g g G G g g G g G G G g g G G g G G G G G G G G g G G G G g g g g G g g G G G g g G G G G G G G G B
B g G g G g g G G g G g G g g g G g G G g G G G G g G G g g G G g g G G g G G g G G G g g g G G g G g G G G G g G G G g G G G G g g G g G G G g g G G G G g G G g g G g G g G G G G g G G g G g g g g B
B G G g G g G g G G G G g G g G g G g G G G G G G G G g g G g G g G G g g G G g G g g G G G g g G G G G G G G G G g G g G g g g G g G G G g G G G G g G G g g g g g G G G g G G G G G g g g G G G G g B
B g g G G g G g g g G g g g g G g G G G g G G G g g G G G g G G G G g G g G g G G G g G G g G G G G G G G g G G G g G G G G g G G G G g G G G G G G G g G G g G G g G G G G G G G g G g G G G G G G G B
B g G g G G g g g g G G G g G g G G G G g G G G G g g G G G G G G G g g G G G G G G G G G g G G G g g G G G G G G G G G g G g g G g G g G G G G g G G G G g G g G G G g G G g g g G g g g G g G G G G B
B G g g G G g G g G G G g G G G G G G G G G G G g g g g g g g G g g g g G G G G G g g g g G g G g G G G g G g G g G G g g G G g g G g g G G g g G G G G G G G G g g G g g G g g G g g G g G G G g G G B
B G g G G G G g G G g G G G g G g G G G G G g G G g g g g G g g g G g G g g g g G g g g G G G G g g G g g g g G G G g G G g g G G G g G g G G g g G G g G G g G g G g g G g g G G G G g G G G g G g G B
B g G g G G G G G G G G G G G G G g g g g g G G G G g g G G g G G G G G g g G g G g G G G G g G g G g G g G G g G g g G G g g g G g G G g G G G g G G G g g g G G G g G g G G G G G g g g G G g G g g B
B G g G G g g g G G g G G G G g g G g g G g g G G G g G g g G g g g g G G G G g G g G G g G G G G G G g G G g g G G g G g g g g g G G g g G g g G g g G G G g G G G G G g g g g G g g g G g G g G g G B
B G G g G G g G G G G g g G G g G G g G g G G g G G g g g G G G G g G G g g g G g G g G G G g g G G G g G G g G G g g G g G G G G G G G G G G G G G g G g g G g g g g g G g G G G G G G g G G g g G G B
B g G g g G G g g G g G G G G G G G g g G g g g g G g g g G G G G g g G g g g g G G g G g g G G g g g G G G g g g g G G G G G g G G g G G g G g G G G g G g G G g G g G G G g g g G G g g G g g G G g B
B G g G g G G G G G g G G G G g g g g g G G G g G g g G G G G G g G G g G G g G g G G G G G G G G G g G G G G g G g G G g G G g g G g g g G g g G G G G G G g G G G g g G g g G G G g G G g G G G g g B
B g G G g G g g g g G G G G G G g g G g g g g G G g G G G G G g g G G G G g g g g g G G G G g G g g g G g g G G g g g g g g G G G g G G g G g G g g G g G G G G g g G g G G g G G G G g G G G g g g g B
B G g G G G G G g g G G g g G G g G G g G G g G g G g G g G G G G G g G G G G g g G G G G G G G g g G G g G G G G g g G G g G G G g G g g G G g g g g G G g G g g G G G g g G g G G G g G G G G g G g B
B g g G G G G G G g G G g G G G g g G g g G g g G G G G g g g G g G G G g g G G g G g G G g g g G g g G g G g G g g G G G g G g g G g G G G g g g G G G G g G g G g G g G g G g G G g G g G g G G G G B
B G g G g G G g G g g G g G g G G G g G g g g G G G g G g g G G G G g G G g g G G G G G G G G G G G G G G G G g G G g G G g G g G G g G g G G g G g g G G G G G G G g g g G g g G g G G g G G G G g G B
B g G G G G g g g g G G g G G G g g g G G G g G G g g g G G G G G G g G g G G g G g g G g G g G G G G g G g g G G G g G g G G G g G G g G G G G G G g g G G G g G G g g G G G g G g g G G G G G G G g B
B G g G g g g G G G G g G g G g G g g G G G g G G G g g G g G G g g g g g G G g G g G G g G G g g G g G G G G g g G G g g G g G G G g G G G g G g G G G G G G G g G G G G G g g g G g G G G G G G G G B
B G g G G G G g G g G G G G G g G G G g G G G g G G g G G G G G G g G g g G G G G G g g g G g G g g G G G G g g G G G G G G g G G g g G G g g G g g G g G G g G G G g g g G G G g G G g g G G g G G G B
B G g g g g G g G G G G G G g g G G g g G G G G g G G G G g g G G G G G g G g g G G g g g G G G G G g G g G g g G G g G G G g G g g g G G g g G g G G G G g G G G g g G g G G G g G G g G G G g G G g B
B g G g G G G G g G G G G G g G g G g G G G G G G G G G g G G g G G G g G G g G g G G G G g G g G g G g g g G G g g G g G G g G G G g g g g g G g G G G G g g G g G G g G g g g G g g G g G G G G G G B
B g G g g G G g G g G g G G G g G G G G G g G G g g G g G G g G g g g g G G G G G G G G g G G g g G G G G g G g G G G g G G G G G G G g g G G g G G g G G G G G g G G g g G g G G G G g g g g g G G G B
B g g G G G g g G G G G g G G g g G G G G g G G G G g g G G G g G G G g g G G G G g G G G G G g g g G G G G g G G g G g G g g G G G G g G G g G G g g g G G G g G g g g g G g G g G g G G g G G G G G B
B G G g G g G g G g g G G G g G G G G g G g G G G G G g G G G G G G G G g G G g G G G G g g G g G G G g g G G g G G g g G g G G G g G G G g g g g g G g g G G G G G g G G G G G g g G g g g G G g g g B
B G g G g G G g G G g g G G G g g G G G G G G G G G G g G G g g G G G G G G g G g g g G G g G G g g G G G g g g g G G g G g G G G g G G g G G G G G G G G G G g G g G g G G g g g G g G G g g g g g G B
B G G g G G G G g g G G G g G g g g G g G g g g G G g G G g g g g g g g g G G G g g G G g g g G g g G G G G g g G G g G G G G G G G G G G g G G G G G g G g g G g g G g G g G g g G G G g g G g G g G B
B G g G G G G G G g g G g g G g g G g g G g G g g G g g g g G G G G G G g g G G G G g G G g g g g G G g G G G G G g g G G G G G G G g g G G g g G G G g G g g g G G G G g G G G G g g g G G g G G G G B
B G g g G g g G g g g g G G G G G G g g G g G g G g G g G G G g g G g G G G g g G g G G G G G G g g g g G G g G G G G G g G g G G g g G G g G g g G G g G g G G G G G G g G g G G g g g G G G G G G G B
B G G G g g g G g g G G g G G g G G g g g g g g G G G g g g g G g G g g G g G G g G G g g G G G g g G g g G G g G G G G G g g G G G G G g G G g G g G g g G G G G G G g g g G G g g G G G G G G g g g B
B g G G g G G G g G G G g g g G g g G g g g G g G g g G G g G g g g g G G g G g G g G G G g G G G g G G g G G g G G G G g G g G G G g g G G g G g G G G G G G g g G g g g g G G g g G G G g G G G G g B
B g g G G G G G G G g g g G G G G G g G G g g g G G g G G G G G g G G G g g g g G g g G g g G g G g G G g g g G G g G G G g G g G G G g g g G g G G g G G G G g g g g G G g G g G G G g g g G g g g g B
B G g G G G G G g G g G G g G G G G g G G G G G g G g g G G G G G g g G G g g G g G G G G g G G g G g g g G g G g G G G g G G g G G g g g G g g g G G g G G G G G G G G g g g g g g g g G G G G G G G B
B G g G G g g G G G g g G g G g g G G G G G G G g G G G G G g G G G G G G G g G g g G G G G G g G g G G G G G G g G G G g g G g G G G G G g G G G g G G G G G G G g g G G G G G G g g G g G G G g G G B
B g G G g G G G G G G g G G g G g G G g g G g G G G g G G G G g G G g G G G G G G G G G G G G G G G g G g g G G G g G G G g G G g G G g G g g g g G G g G G g G g g G G g g g G g g g g g g g G g G G B
B G G g G G G g g g G g G g G g G g G G g G g G G G g G G g G g G g G G g g g g G G G G G g g g g G G g G g G g G G g g G G G g g g g g G G g G G g g g G g G G G g G G g g g g G g G G G g g g G g G B
B g G G G g g G G g g g g g G G g g G G G G G g G G G G g g g g g G G g g G g g G g G G G g g g G G G G G g G G g G G g G G g g G G g G G g G G g g G g G G g G g G G g G g G g G G g G G g g G g g G B
B G G g G G g G g g g G g G g G G g g G G G g g G G G G G g G G g g g G G G g g G g G g G G g g G G G G G G g G g G G g g G g G g G G g G G G g G G G G g G G g g G G g g g g g g g G g G G G G G G G B
B G g G g g G G G G G g G G G g g G G g G G g G G g g G g g G g G G G G G G g G G g G G G g G G G g g g G G g g G g G g G g G g g G g G g g G g g G g G g G g g g g G g G G G G g G g g G G g g G G g B
B G G G G G g G g G G g G g g g G G g g G g G G G G G g G G g g G g G g g g G G G G g G G g G g G G g g g g g G G g G G G g G G g G G G G G g g G g G g G G G g g g G G g G g G g G G G g g G G G g g B
B G g g g G G g G g g g G g G g g g g G G g g g G G g g g g G G g G G g g G G g G G g G G G G G G g g G G g G g G G G G g g g G g g G G g g g G g g g G G G g G g g G g G G G g G G G G G g g G G G G B
B G G g G g G G G G g g G G G G G G G G G G G G G g g G g g G G G G G G G g G G G G G g G G G G g g G G G g g G g G g G G g g g G G G G G G g g g G G G G G G G g g g G G g g G G G G g G G g g G g G B
B g G G G g g G g g G G G G g G G g g G g g g g G g g g G g G G G G g g G G g G g g G G G g G G G g G G g g g G g g g G G G G g g G G G g g G g g g G g G G G G G g G G g G g G G G G g G g g G G G G B
B G G g G G G g G g g G G g g g G g g G G g g G g g g G G g G G G G g G g G G G G G g G g g G G g G G G g G g G g g g G g G g G g G G g g G G g g G g g G G g g G g G G G g G G g g g g G g G g G G g B
B G G G G g G G G g G g G G G G G G g G G g g G G g G G G G G G g g G G G G g G g G G G G g g g G G G G G G g g g g g g g g G G G g g G G G g G G g G G G g g g g G G G g G G G g G G g g G g G g g G B
B g G G g G g g G G G g G G G G g g G G G G G g G g g g G g g G g G g G G G G G G G G g g g G G g g G G G G g G G g G g g g g G G g g G G G G g G G G g G g g G g G G G G G g G G g G G G g g G g G G B
B g g G G G G G G G G G G G g g G g g g G G G g g G G g G g G g G G G G g G G G g g g g g g g G G G g G g G G g G g G G G G G g G G G G g G g g g G g g G G G g g G G g g g G G g G g G g G g G G g g B
B G G G g g g G G g G G G G G G G g G G g G g g g g G g g G G g G g G G G G g g G g g g G g G G G g g G G G G G g G G g g G G G G g G G g g G G G g G G g G g G G G G g g G g g g G G G G g G G g G g B
B g G g G g g G g g G g G g G G g G g G g G g g g g G G G G g G g g g g g G G g G g G g G G G G G G G g G G g g G g G g G G g g G G G G G g G G G G G g G G g g G G g G G G G G G g G G g G G g g G G B
B G g g G g G G g g g G G G g G G G G G g G g G G G G G g G g G g G g G G G g G g g G G G g g G G G G G g g G G g G G g g G g G G G G g g G g G G G g G G G g G G G g G g G G G g G g G G G g G g g g B
B g g G G g g G G g G g G G G G G g g G G G G G G G G g g g G G g G G G g g G G G g G G G G G G g g G G g G G G G G G g G G g g g G g G G G g g g G G G G G G G G G G g G g G g g G g G G g G g g g G B
B g G g g G g G g G G G g g G g G G g G G G g g G G G G g G G G g g g g G G G g G G g G g G G g G G G g G G g G G g g g G g G G g G G G G g g g g G G g G G g G G g g g G G G g g G g G G G G g G G G B
B g G G G g G G G g G G G G G G g G g G g G G g G g g G g G G G g g G G g G g G G G G G G g G g G G g G g g g g G G G g g g G G G G G G G g G G g g G g g G G G G G G g G G G G g g g G g g g G G G G B
B G g g g g G G g G g G g G G G G G g G g G G g G G g G g G g G G G g G G G G g g G G g G G G G G g G G G G g G G g g G g g G G G g g G G g g G G G G g G g G G G G G G G g G G G g g g G g G g g G G B
B g g G G G G G G g G G G G G g G G G G g G G G G G G G G g G G G G G G G g G g g g G G g G G G g g G g g g g G g g G G g G G G G G G G G g g g g g G G G G G G G G g g G G G G G G G g g G G g G G g B
B G g g g G G g g g g G g G g g g G G G G G G g g g G G G G G G G G g G G G G G G G G G g G G g g G G G G g g g G g g G g g g G G g G G G G G G g g g g G G G g g g G g g g g G g G G G g G G G G G G B
B G G g G G g G G g g G g G G G g g g G G G g g g g g G G G g G G g g g g g G g G G G G G g G g G G G G G g g G G G g G g G G g g g G g g g g g G G g g G g g g G G G g G G G g g G g g g g G g g g g B
B G g G g G G g G G g G G G G G G G G G G G G g G g g G g g G g g g g G G G g g G G G g g G G G G g g g G G G G G g g G G G G G G G g G G G g G G G G G g g G g g g G G g g G g G G g G g G G G G G G B
B G g G G g G G g g g G G G g G G g g G G G G g G g G g g G G G g G G G G g g g G G G G g g G G g G g g G G g G G g g G G g g g G G G g G G g g G g G g G g G G g G g G g G g G G g g G g g g g G G G B
B G G g g G G G g G G g G G G G G g G G G G G g G g G G G g G g G G G G G g g G g G g g G g G G G G g G g G G g G G G G g g g G G G G G g G G G g g g G G G g G G G G G g G G G G G g G G G g G g G G B
B G g G G G G G G G G G G g g G G G G g G G G g g g G G g G G g G g g G g G G G g G g G G g g G G g G G g g G G G G G g G G g G g g G g g G g g G G G g G g G g G g g g g G G G G g g G G G g G G G g B
B G G G G G G g g G G G G G g G G G G G g g G g G G G G G G g g g G G G G G g g g G g G G G G G g g G g g G g G g g G g g G G g G G g g G g g G G g G g G G G g g G G G G g G G g g g g G G g g g g g B
B G G G G g G G G g G G g g G G g g g g g g g G G g G G G G g g G g G G G g g g G G G g g G G G g G g g G g G G G G g g g G G G g g G G G g G g G G g G g g g G G g G G g g G G G g g G G g g G G G g B
B G G G g g g g g g g G G g g G g G G g G G G G G G g G g G g g G G G G G G G G G g G g g g G G G g g g G G G g G G g g G g G G G G g g G G G g g G G G g G g G g G g G G g G G G g G g G G G g G G G B
B g G g G G g G g G G G g g G g g g g G G G g g G g g g g g G G G G G g g g G G G g G G G G g G g G g G g g g g g G g G G G g G G G G g g G G g g g g G g g G G G G G G G g g g G G g G G G G G g g G B
B G g G g g G g g G g G G G g G g G G g g g G G G G g G g G G g g G g g G G g G G G g g G G G G G G G g G g G G G G G G G g g g G G G G G G G g G g G g G G G G G G G g G g g G g G G G G G G G G g g B
B g G G G G g g g g G g G G G G g g g G G g G g G G G G G G G G G G G g G g g G G G G G g g G g G G G G G g g G G g G G G G g G G g g g G g G G G G g g G g G G g g g g G G G g G G G g g G G G G g g B
B G g g G G G G G g g G G g g G G G G g G G G g g G G g G g G G g g G g G G g G g g g G g g g g G g G G G g G G G G G G G g g G g g g g G g G g g g g G g G G g G G G g G g G G G g G G g G G g G G G B
B g g G g G g G g G G g G G G G G G G G G G g g G G g G G G G g g g G G G G g G g g g G g g G G G G G G G g G G g g G g G g g G G g G G g g G G G g G G G g G G g G g G G g g G G G G G g g G g G G G B
B G G g G G G G G g G G g g G G G g g G g G g g g G G G G g g G g G G g G G G G G g g G G G G g G G G G g G G g G g G G G g G G G G g g G G g G G G G g G G G G g G g G g g G G G g G G g G g g g G G B
B g g G G g G G G G G G g g G g g g g g g G g g g G G g g g G G G g g g G G G g g G G g g g G G g G G g G g G G G g g g G G G G g g g G g G g g G g G G g g G G g G g g g G g g G G G g g g G G g G g B
B G g G G G G g g G G G G g G g G G g G g g g G G G g G G G g G g g G g g g G g g G G g g G G G G g G G G G g G G g g G g g G G g G g G G g G g g G g g G G G g G G G g G g g g g g G G g G G G G g G B
B g g g G g g G G g g G g G G G G g g g G g g G G g g G G G G g G G g G g g G g g G g g g g G G G G G G G G G g G g G G g G G g G G G G G G G G g G g G g G g g G g G G G G G G G g g g G G g g G G g B
B g G G g G G G G g G G G g g G G G G g G g G g g G g g g G g G G g g G G g G G G G G G g G G g G g G g g G G G G G G G G g g g G G g g g g g G G G g G g G G G g g G G G G g G G g G g G G G G G G G B
B g G G g G G G g g g g g G g G G g g g G G G G g G G G g g g G G g g G g G G G G G g g g G G G G G g g g G G G G g G g G G G g G G g g G g G g G G G g G G g G g g G g G g G g G g G G G g g g g G g B
B g G G G G g G G G G G G g G g G G g G G g G G G G G g G G G g g G g G G g G g G G g G G G G G g G g G g G g G G g g g G g g g G G G G G g g G g G g G G G G G G g g G G g g G g G G g G G G G g g g B
B G G G G g G G g G g G G g G g G G g G G g g G G G G G G G G g G g G G g G G G g G G G G G G g G G g g G g G G g g G g G G g G G g G G G G G g G G G G G G g G G G G G G g g G G G G G G G G G g g g B
B g G G G g G G g G G g g G g G g g G G g g G G G g G G G G G G g G g G G G g g g G G G g g g g g g G G g G G g G G G G g G G G g G G g G g g G G G g G g g G g g G g g g g G g G g g G g G G g G G g B
B G G G G G G G G G G g G G g G g G G g g g g G g g g G g g G G G G G G g G g G g g g G G g g G g g g g G g G G g G g g G G G G G G G G g g G g G g G G g g G G G G G G g G g G G G G g g g G G g G g B
B G G g G G G G G g G G G G G g G G G g G g G G g G g G g G g G G G g G g G G G G g G g g G g G g g G g g g G G g g G g g G g G G G G g G G G g g g g G G G G g G G G G G G G G G G G G G G G g g G G B
B G g g G g g g g G G g G g g G G G G G G g G G g g g g G G G g G G g G G G G G G g g G G G G g g g G G g G G G G g g g G G G G g G g G G G g G G G G g G G g G G g g G G g g g G G g G g g G G G g G B
B G g G g G g G G G G G g G g G g G G G G g G g G G g G g G G G G g G g G G g G G g g G G G g G G G G G G g G G g G g g g G g G g G g G G G g G G G G G G G G G G G g G g g G G G g G g g g G g g g g B
B B B B B B B B B B B B B B B B B B B B B B B B B B B B B B B B B B B B B B B B B B B B B B B B B B B B B B B B B B B B B B B B B B B B B B B B B B B B B B B B B B B B B B B B B B B B B B B B B B B B