B B B B B B B B B B B B B B B B B B B B B B B B B B B B B B B B B B B B B B B B B B B B B B B B B B B B B B B B B B B B B B B B B B B B B B B B B B B B B B B B B B B B B B B B B B B B B B B B B B B B
B g G g G G g G g G g G g g g G G g g g g G G g G g g G G g g G G g g G G G G g G g G g g g g G G G g g G G g g g g g G g G G g G G G G G g G g G G G g G G G G G g G G G G g g G G g G G G g g G G G B
B G G g G G G g G G g G G G g g g G g g g G G G g G g g G G G g G g G G G G G G g g g G G G G G g G G g G g G G G g g G G g G G g g g G G g G G G g G G g G G g G g G g G g G g G G G G G G g G g g g B
B G G G g g g g g G G G G G G G G g G G G G G G g G G g g G G g G G G G G g G g g G G G g g G G g G G G G G G g G G G g G G g G G G G G G G G G g G g g G G G G g g G g G G g g G g G g g G G G G G G B
B g G G G G G G g G G g G g g g G G g G g g G g G G G G G g G g g g G g G g G G g g G G G G G G g G G g G G G g G G G G g g G g G g g G g g G g g G G G G g g g G g G G G g g g g g g G G G G G G g g B
B G G G G N G G g G g G G g G G g G G G G G G G G G G G G G G G G G G g G G G G g g G G G G g G G G G g G G G G G g G g G g G G G G g g G g g G g G G g G g g G G g g g g G g G g g G G g G G g g G G B
B G G G G g g g g g g G g g G G G g g G G G G G g G G G G G g g G g G g g G G g g G G g G G g G G G G G g g g G g G g g g G g G G G G g g G G G g g G g G g G G G G g g g g g G g G g G G G G G G G g B
B g G g G G g G G G G G g g g g l G g G g G g g g G g G G G G G g G G G G G G g g g G G G G G g G g G G g G G G g G g g G g g g g G G G g G g g G G G g G g g G G G g g G G G g G G G g G g g G G g G B
B G g g G G G G g G g G G g G l l l g g G G g g G G G G g G g g g G G g g G g G G G G G g g g G G g G G G g G G G G g g G g g g g G G G g G g g g G G g g G G G g g G g g G g g G G g g g G G G g G G B
B G G G G g g G G G G g G g l l l l l G G l G G g g g g G g G g G G g G G G g g G G g G G G G G G g G G g G g g G G g g g G g G g G g G g G G G G g G G G g g G G G G g g G G g G G G g G G G g G g G B
B G g g G G G G G g g g G G G G L g g g l l l g g G G g g g g G g G g G g G G G G g G G g G g G g g g G G g G g g G G g g G G G G G g G g g G G G G G g G g G G G g g g G g G g G g g G g G G G G g G B
B G G G g G G G g g g G G g g G L G g g G L G G G G g G g G G G g G g G G G g g g G g g G G G G G G g G g g g g g g G g G G G g G G G G G G G G G g g G G G G G G G G G G G g G G g G g g G G G g G G B
B g G G g g g G G g g g g g G G G G g G g g g G G G G G G G g g g G g G G G G G G G G G g G G g G g G G g G G g g G g g G G G g G G G G g G g g g g G g G G G g g G G G g G G g G G G G G g G G G G G B
B G G g g G g g g g G G g G g G G g G G G G g G g G G g g g G G G g g g g g G G g G G G G G g G g g G G G g g g G G G g g G G g g G g G G g g G G g g G g g G G G G G G G G g g g G g g G G G G g g G B
B G g G G G G G g g G g G G g G G g g g G g G G G G G G g g G G G g g G g G G G G G G g g g G G g G g G G g g g G g g g g G G G G G g g G G g g g g g g g g G G G G G G G G g G G G G G G G g G G g g B
B G g G G g g G g G g g g g g g g g g g G G g g G G G G g g g g G g g g G g g G G G g G g g G G G G G G G G G G G G g G g G G g g G g g G G G G g g G G g G G G g g G G G g G g g g G G g G G G G G G B
B G G g g G G G g g G g G g G g G g G g G g G g G g G G G g G G g G G G g g G g g G g g G G g g g G g g G G g g g g G G g g G G G G G g G G g g g G g G G g G G G g g G g g G G g g G G g g g G G G g B
B G G G g G G G G g g g g g g g G G G G g G G g g g G g G g g G g G G g G g g G g G G G g G G g g G G g g G G g G G g g G g g G G g G G G g g G g G g G G G g G G G g g G g g g g G g g G g g G G G g B
B G G G g G G G G G G G G g G G G g G G G G G G g g G g G g G g G g g G g g g g G G g G G g g G G G G g g G g G g g G g G G G G g g G g G G G G G g G G g G G G G G G G G G G G G G g g g g G G G G G B
B g g g G g G G g G g G G G g G G G G g g g G g g g g G g G g G G G G G G G G G G G G G g G g G g g g G G G G g g G G G G G G g g g G g g g g g G g g G G G G G g g G G G G G g g g g G G G G g g g G B
B g G G G G g g g G G G G g g G g g g G g G g G G G g g g G G g g G G g g G G g G G g G G G g G g G G G G G G g G g G G G G G G G g G g G g g g g G g g G G G g G G G g G G g G G G G G g g g G g G g B
B G G g G G G G g G G G g G g G g G G G G G G G G G G G G g G G G G G g G G g G G G G G g g g g G G g G g G g G G G G g G G g G g G G g G G G g G G G G g g G G G G G g G g g G g G g G G G G G g G G B
B G G G G G g G g G g g G G g G g g G g G G G G g G g G g G G G g G g g G g G g g g G G G G G g G g g g g G G g G g g G G G G G G G G G G g g G G g G G G g G g G g G G g G G g G G g G G G g G g G G B
B g g G G g G g G g G G g G G G g G g G G G g G g g G G G g G g G G g g G G g G g G g G g G g G G G G G G G G G G G G G g g G G g G G g g g g G G g G g g G G G G G G g g g g g G g g G G g g G g G G B
B G G g G g G g g G G g g G g G G G G g G G G g g G G g g G g G G G G G G g G G g G g G G G g g G g g G G G g G G g G g g g G G G G G g g G g G g G g G G G G g g g g G G g g g G g G G G G G g G G G B
B G G G G G g g G g G g G G g G g g G G g g G G G G G G g G G G G G G g G G g g G g G g g G G G g G g G G G g g G G g g g g G g g G g g g g G G G G G G g g g G G g g g G G G G g g G g G G G g g G g B
B G g g g G G g g g G G G G G g g G G G g G g g G g G g G g G g g G g g g G g G g g G g g G G G G g g G G G g g G g G G g G G G g G g G G G G G G g G g G G G G G G G G G G G G g g g G G G g G G G g B
B g G g g G g g G G g G g G g G G G G G G g G G G g g g g g G G G G G g G G g G G G g G g g g G g G g g g G g G g g g g G G G G G G g g G g g G G G G G G g G g g g G G G g g G G G g G G g g g G g g B
B G G g G g G G G G G G G g G G g g G G g G G G G G G g G g G g G g g G G G G G g g G g g g g G G g G g g g g g g g G G g G G G G g G G g g G g G G G g g g g G G g G G G g G G G g G g G g G G G G G B
B g G G g g G G G G g g G G G G G G G g G G g G g G G G G G g G G g G g g G g G g G G G g g g g g g G G G G G g g G G g G G G G g g G G G g G G G g G G G g g G g g g G G g g G g G G g g G G G G G G B
B g G g G g g G g G g G G g g g G G g G G g G G G G G G g g G g G g G g G G g g G G g G g G G G G g G G G g G G g g G G G G G G G G g G G g g G g G G G G g G g G G G g G g G g G G g g G G G G g g g B
B G G g g G g g g g G G G G g g G G g G G g G g g g g G g g g g G g g G G G G g g G g G G G G G G g g G g G g G G g G G G G g G g G G g G g G g g g G G G g G G g g G g G G g G G G G G g G G G G g G B
B G G G G g G g G G G G G G g G g g G G g G g G g G G g G G g g g G G G G g G g G G g G g G g G G G g G G g g G G G g g g g g G g G G g G g G G G G G g G g g G G G G g G g g G G G G G G G g G G G G B
B G g g g g G g G G G G G g G G G G g g G G g G g g G g g g G G g g G g G g G G G G G g G g G g g G g G G G G g g G g g g g G G g G g g g g g G g g G G G G g g g g G G G g g G G g G g g g G g G g g B
B g g g G g g G g G G g G G G G G g G g G G G G G G g g g G g g g G g G G g g G G g G G g G g G G G G g g G G g g g G G G G G g g G G G G G g G G G g G G g G G G G g g g G g g g G G g g G g G g g G B
B g G g g G G G g g G G G g G g g G G g g G G g G G G G g G g G g g G G G g G G g g G g G G G g G G g G G G G g G g G G g G G G G g G g g G g G G g G G G G g g g g G g G G G g g G G g G G G G g G G B
B G G G G G g g G G g G g G g G G g g G G G g g G g g G G G g G G G g G G G g g g g G g g G G G G g G G g G g G G G G g g g G G g g g G g G G g G G g G g g g G G G G G g G g G G g G g g G G G g G G B
B G G G G G G G g g g g G G g g G G g G G g g g G g G g G G G G G g G G G g g g G G g g G g G G g g G g g g G G g G g g G g G G g G G g G g G G g g G G g G g G g g G G G g g G G g G g G G G G G G G B
B G G g g G G g G G g G g g G g g G g g G g g G G G G g g G G G g G g G g g g g G G g g G G G G G g g G G G g G g G G g g g G G G g G G G g g g G g G g g g g g G G G G G G g G g G G G G G G g G G g B
B g g G G G g g G G G g G G g G G G g G G G G G G G G g g g g G G G g g G G g G g G G G G g G G G G g g g G g g g G G G G g G G g g g G g g G g G g G G G G G G G g G G g g G G G G g g g g G G G G G B
B g G g G G G g G G g G g g G G g G g G G g G g G g G g G g g g g g G G G G g G G G G g G g G G g g g G G G g g G G g g g G g G G G g G G G G g g g G G G G G G G g G G g g G G g g G g G g G g g G G B
B G G g G g G G g G G G G g g G G G G g G G g G g g G g G g G G G g G G g G g G g g G g G G G G G G g g g G g g G G g G g G G g g G g G g G G g g G G g g G g G G G g G G G g G g G g g G G G G g G G B
B G G g g G G G G g G G g G G G g G g g G g G G G g G G g g G g g G G G G G g g g G g G G g G G G g G G g G G g g G g G g g G G G g G g g G g G g G g g g G G g G G G G G G g G g G G g g g g g g G g B
B G G g G G G g G g G g G G g G G G g g G G g g G G G G G g G G g G G G G G g G G G G g G G G g g G G g g g G g g G G G G G g G g g G G g G G G G g g G G g G G g G g G g G g g g g g g g g g G g g G B
B G G G G G G G G G G g g G G g G G G g g G G G G g G g g G g G G G g G G g G g G g g g G G g G G G G G G G G G G G G G g G g G g g g g g G g g G G G g g G G G G G g G g G G G g g g G G g g G g g G B
B g G G g g g G G G g g g g G g G G g G g g g G G G g G G G G g G g G g g G g G g g g G G g g g G G G G g g G G g G G G G G G g G G G g g G g G G g G g g g G G G G G g g g g g G g g G g g G G G g G B
B G g g g g G g G g G G g G g G G g g G g G G G G g G g G G G g G G G g g G G G G g G g G G G g g G g G G g g G G G g G g G G g g G G G G g g g G g g G g G G g g G G G G G G g G G G g g G g G G g G B
B G G g G g G g G g g g G G G G g G G G G g g G g G G G g G g G g G G g g g G G G g G G g G g G g G g G G g G G g g G G G G g G G G G g G G g G g G g g G G g g G g G G G g G G g G G g G g g g G g g B
B G G g G g G g G g g g g G g G G G G g G g G G G G G G g g g g G G g g G G G G g g G G g G G G G G g g G G G g g g G g g g G g g G g g g g G G G g G G G G G G g G G g g G G g G g G g g G G G G G g B
B G G g G g G G g g g G g G G G g g G g g G g G G G G g G g G g G g G G G G G g g g g g G g g g g g G G G G G G g G G G g g G g G g G G G G g g G G G G G G g g G G g G g G G g g G G G G g g G g g G B
B g g G G G g g G G g g G g G g G g G G g G g G G G G G G G G G g G G g g g g g G g g G g g G g G G g g g G G g g g G g G g G g G G G G G G g g G G G g G G g g g g G G G G G G g G G G g g g G G g G B
B g G g G G g G G g G G g G G G G G g g G G g G g G g G G g G g g G G G G g G G G G g G g g G G g G g g g G g G g G G G G g G g g g g g g G g g g g G G G g G G g g G G G G G g g G g G G g G G G G G B
B g g G g G G G g G G G g g G G G g G g G g G g G G g g G G g G G g g g G G G g G G G g G g G G g g G G G G G G G g G g G g G g g G g G G G g G G g G G g G G G g G G G G g g g g G g G G g g G G G G B
B G g G g G G g g g G G G G g G g g g g g G G g G G g G G G G g g G G g g G G G G G G G G G g G g G G G g G G g G g G G g g g g G G G G G g G g g G G G G G g g g G G G G g G g G G G g G g g G g G G B
B G G G G g G g G g G G G G G g G g G G G G g G G G G G G G g g G G G G g g G G g G g g g G G G G G G G g G G G G g g G G g G g g g g g G G G G g g G g G g g G G g g g G G g g G g G G G G g G G G G B
B g G G G G G G G G g G G G g g G g g G g G G G g g G g G G G G G G g g g G G G G G g G G g G G g G G g G g G G g G G G G G g g g G G G G G g G G G G g g g G G G g G G G g G G g g G G g G G G G G G B
B G G G g g G g G G g G g G g G G G g G G g G g G G g g G G g G g G G g G G G g G g G G G G g g G g g g G G G G G g G g g G G G g G G G g g g g G G g g g G g G G G G g g g g G G G g G G g G g G g G B
B G g g g G g G G g G G g G g G G G G G G G g G G G g g g G G G G g G g g G g G g G g g G G G g G G g G G G G g g g G G g G G G g G g G G g g G g G G G G G G G g G G G G G G G g g G G G G G G G G g B
B g G G g g G G g g g G g G G G G g G g g g G G g G G G G G g G G g G G G g g g G G g G g G g G g g G G G G G g g G G g G g G G g G g G g G g G g g g G g g g g g G G G G G g G G G G g G g g G G G g B
B G G g G g g G G G G G g G g G G g G G G G G G g G G G G g g G g G g G G g G G G g G G G G G g g G G g g G g G g g G g G g G G g g G g g G g g g g g G g G G G G g G G g g G G G G G G G G g G g G G B
B G G g G g G G G G g G G G G G g G G G g g G G g g G G G g g G g G g G g G G G g G g g g g g g g G G g g G g G g g G g G G G G G g G g g G g G G G G g G G G g G G G G G G g G G G g G G G G g G g G B
B G G G g G G G g G G g g g G G g g G G g G G G G G g g g g g G g G G G G G G g G G G G G G G G G G g g g G g G g G g G g G g g G g G G G g G g g G g g g g g g G g g G G G g g G G G G G g G G g G G B
B g g g G G G G g g g g G G g G G g g g g G G G G G g G G G g G G G g G G G g G G g g g g g g g g G G G g G G g g G G g g G G G g G G g G g g G g g G G g G G g g G G G G G G G g g g G G G g G G G G B
B G G G g g G g G G g G g G G G G g G G G G G G G G G G G g g G G G g G g G G G g G G G G g G g g G g G g G g G G G g G g G G g g G G g G g G g G g g G g G G G g G G g G g G g g G g g G G g G g G G B
B G G g g G g G g g G g g G g g G g g g g G G G G g G g G G G G G g G G g G g g G G g G G g G G G g G g g G G G g g g g G g G g G g G G G g G G g G G g G G g G g G G g G g G g g g G G g g G G G G G B
B g G G G g G g g g G g G G g g G G G G G g g G G G G G g g G g G g g g g G g g g G g G G G g G G G G g G g g G g G g G g G g G g g G g G G G G G G G G g G G g g g G g G g g g G g G G g G g G G G g B
B g G g G g g g G g G G G g g G G g g g G G g G G g g g G G G g g g G G G G G G G g G g g G g G G G G g g g g G G G G g G G G G G G g G g g g g G G G G G g G G g G g G G G g g G G g g g G G G g G g B
B G G g G g G G G g G G G g G G G G G g G g G G g G g g g G G g g G g G G G G g g G G G G G G G G g g G g G g G G g g G G G G g G g G g G G g G g G g G g G g G G g g G g g G G G g g G G G G g g G G B
B g g G g g G g G G G g G G G g G g g g G G g g G G g g g G g G g g G G G G G G G g g G g G g G G g G G g G G g g G G G G g G g g G g G G g G g G G G g G g G G G G g g G g G G g g g G g G g G g g g B
B G G G G G G G G G g g g G g G G g G g G g G G G g G G g g G G g G g G G g G G g g G G g G G G G G G G G g g G G G g G g G G g G g G G g G g G g G G G g G g G G G G g G g G g g G g g G G G g g G g B
B G G g g G G G G G G G g G G g G G G G g G G g G g G G g G G g G G G g g g G G g g G G g g G G g G g G G G G g G g G G G G G G g g G g g G g G G g G G G g G G g G g G G G g g G g g g G G G g g G g B
B g G G g G G g G G G G g G G G g G g G G G g G G g g G G g G g G g G G G g g G g g G G G G G G g G G g G G g g G G G g G g G g G G g G G G g g g G G g G g G g G G G G G G G G G G G G G g G G G G G B
B G G G g g G g g G G G G G G g g G g g G G G G G G G G G G g g G g g G G G G G g G G G g G G G G g g G g G G G g G G g G G g g G g G g g g G g g g G G g g G g G g G G G g g g G G g g g G G G G G G B
B G G G g G g g G G G G G G g g g g G G G g G g g g g G g G g G G G G g g G G G G g G G G G G g g g g g G g G g G G g G G G G G G G G g G g G g g G g g G g G g G g G g g G G g g G G g g G g g G g g B
B G G G G g G g g G G G G g G G G g g G G g G G g G g G g G G g G g g G G g G G G g G G G G g G G G g g G G g g G G g G G G G g G G G g g G G G g G G G G g G g g G G G G G g G g G g G g G G G G g G B
B G g g g G G G G G G G g G G G g G G G G G G G G g g G G g G G G G G g G G g g G g G G g G g g g G g G G G g G G G G G g G G G g G G g G G G g G G G G G G g g G g G G G g G G G G g G g G G G g G g B
B G g G G G g g G g G g G g g g G g G G G g G G G g g G G G g G G G G g G G G G g g G G g G G G g g G G G G g g g G g g g g g g G g G g G g G g G G G g G g G G g G g g G G G G G G g G G G G G g G G B
B G g G G g G G G g G G g G g G g G G G g g G G G G g G G g G g G G G G g g G g G G G g g G g G G g g g g G G g G g G G G g g G G G G G g g G G G G G G G G g G g g G g G g g g g G g G G g g g G G g B
B g G g g G G G g G G G g G G G g G g G g g G g g g g g G G g g g G G g G g G g G G G G G G G g G G G G G G G G g G g g G G g g G G g G g G g g g G G G G g G G G G G g G G g G G G g G g g g G g G G B
B g G g G G G G g g g G G g g G G G G g g G G g G g G G g G g G G g G G G g G G g g g G g g g G G g g g g G G g g G G G G G g g G g g G g g G g G G g G G G G G G g G G G G G g G G g G G G G g G g g B
B g G G G G g g G g g G g G G g g G G G G g g g g G g G G g G G G g g G G g G G G G G G g G G G G G G g G G G g G G G G g g G G G g g g G G g g G G g G g g g G G g G G g G g G G g G g g g G g G g G B
B G G G G G g G g G G G G g g G g G g G G G g G G G G G g g G G g G G g G g g g G G g G G G G G g g g G g G G G g G g g G g G g g G G G g G g g g G G G G g G g g g G G G g G G G g g G G G G g g G g B
B G g G g G G G g g G G G G G G G g G G G g G G G g g G g G g G g G G g G g g g g g G G G g g G G G G g g G G G g G G G G g g g G G g G G g g g G G G G G g G g g g G g g g G G G g g G g g G G g G g B
B g G g g g g G G G G g G G G g g g g G g g g G g G G G G g G g G g g G g g G g G G G G g g g G g g G g G G G G g G g G G G G g G g G g g g G g g G g G G G G G g G G g G g g G G g G g G G G g g G G B
B G G G G G g G G g g G G g G G G g g G G g G g G G G G g g G G g G G g g G g g G G g G G g G G g g G g G G G G g g g G G G G G g G g G g G G g G g G g g g g g G G g G g g g G G G G G g G G G G G G B
B g g g g G G G G G g g G g G G G G G G G G G G g G G G G G g G G g g G g g g G G G g g G G g G g g g G g g g g g g G G g G g G G G g G G G g G G g g g G G G G g G G g G g G g G G G g G G g g G g g B
B G G g g g g G G G g g G g g g G g g g G g G G G G g G G G G G g g g G g g g G g G g G g G G G G G G g G g g G G G G g g g g g g G G G G G G g G G g G G G G G G g G G g G G G G g G G G g g g G g g B
B G G g G g g g G G G G g G g G g G G g g G G g g g G G G g G g g G g G G g G G G G g G G g g g G G g G G G G g g G g G G G G g g g g g g g G G g G G G G g G g G g g G G G G g G G g g G G G G g g G B
B G g g g g G G g G G G g G G g g G G G G g g G G g G g g G G G g g g g g G g G g G G G G G g G G g G g G G g g g G g g G g g g G G g g G g G g G G G G G g g g G g g G g G g g G G G G G G G G g G g B
B G g g G g g g g G G G G G G g g G G g G G G g G G g G g g G g G G G G G G G g G G g G g g G G g G g g G G g G g g g G g G G g g G g G G G G g G G G g G G g g G G G g G G G g g G G G G g g g G G G B
B g G g G G G g g g g g g g g g G G G g g G g G G G G G G g G G G G G G g G G G G G G G G G g G g g G g g g G G g G g G g g G G G G G g G g g G G g G G G G G g g G g g G G G g g g G G G g G g G G G B
B G G g G G g g g G G g g g g g g g G G G g G g G G G G g g G g g g g g g G g G g G g g G G g G G G G G g G G G G g G G g g G G G g G G G g G g G G g g g G g G G G G G g G G g g G G G g G g G G G g B
B g G G G G G G g G G g g G G G g G g G g G G g g G g G G g G G G G G G g G G G G G G G G g G g g g g g g g G g G g g g g G g G g G G G G g G G g G G G G G g G G G G G g g G G G g g G g g g g G G G B
B G g g G g g G g G G g G G G G G g g G g G G G g g g G G G g g G g G G g G G G G g g g G G g G G g G G g G G G G G G G g G G g g G G G G g g G G G G G g G g G g g g g G G G g G g G g g G g g g g G B
B g G G g g G G G G G G g G g g G g G G G G g G g g G G G G g G G g g G g g g G G G G G G g g g G G G g G G g G g G g G G g G G G g G G G g g g g g g G G g G g g g G G G G g G G G g g G G G g G G G B
B g G G g G g G G G G g G G G g G G g g G G G G g G g G G G g g G g g g g G G g g g g g g G G G G g g G G G G G g g g G G G g g G G g g g g G G G G G G G g G G G G G G G g G g g G G G G G g G G G g B
B g g G g g g G g g g G g G G g G G g g G G g G G g G g g g g G g g g g g g G G G g g G G g g g G g g G G g g g G G G g G g G G G G g G G G g G g G g g g G g g g g G g g G G g g g G G G g g g G g G B
B G g g G G g g G g g g G G g G G g G g g G G G g G G G G G g g G G g G G g G G g g g G G G G G g G g g G G G G G G G G G G g G g G G G G g G g G G G g G g G G G g g G G g g g g G G g G G g G G g G B
B g G g G g g g G G G g g G g G G g g G G g G G g g g g g G g g G G g G g g G G g G g G g G G G G G G G G G g G G G G G G g g G G G G g G G G g g g G G G G g G g G G G G G g G G G g G g G g G G g G B
B B B B B B B B B B B B B B B B B B B B B B B B B B B B B B B B B B B B B B B B B B B B B B B B B B B B B B B B B B B B B B B B B B B B B B B B B B B B B B B B B B B B B B B B B B B B B B B B B B B B